1111111111111111111111111111111111
1000000000000MC0000MC00000000000M1
111001010M100000101001000M00010101
101001001010101000100100MEM0010101
1P0001000C0MC0000000000000000000C1
1111111111111111111111111111111111
