1111111111111111111
10000000CM000001111
1001011111000001111
10010000C0000P01111
100M000000000E01111
100011111011M0000C1
1111111111111111111
