1111111111111
111110E011111
1111000001111
1111000001111
1111000001111
1111000001111
1111000001111
111100C001111
1100000000011
100P00000C001
1100001000011
1111111111111